
running 6 tests
test map_generator::tests::test_minimum_room_size_enforcement ... ok
All 7 town templates are valid!
test map_generator::tests::test_room_connections ... ok
test map_generator::tests::test_town_templates ... ok
Generated town map:
########################################################################################
#..................###########..................###########..................###########
#.####........####.###########.###..............###########.####........####.###########
#.#..#........#..#.###########.#.#..............###########.#..#........#..#.###########
#.####........####.###########.###..............###########.####........####.###########
#..................###########..................###########..................###########
#..................###########..................###########..................###########
#..................###########..................###########..................###########
#..................###########..................###########..................###########
#..................###########..................###########..................###########
#..................###########..................###########..................###########
#..................###########..................###########..................###########
#.####........####.###########..................###########.####........####.###########
#.#..#........#..#.###########..................###########.#..#........#..#.###########
#.####........####.###########..................###########.####........####.###########
#..................###########..................###########..................###########
#..................###########..................###########..................###########
#..................###########..................###########..................###########
#..................###########..................###########..................###########
########################################################################################
########################################################################################
########################################################################################
########################################################################################
########################################################################################
########################################################################################
########################################################################################
########################################################################################
########################################################################################
########################################################################################
########################################################################################
#..................###########....................#########..................###########
#..................###########....................#########..................###########
#..................###########....................#########..................###########
#..................###########.....##########.....#########..................###########
#..................###########.....#........#.....#########..................###########
#..................###########.....#........#.....#########..................###########
#..................###########.....#........#.....#########..................###########
#..................###########.....#........#.....#########..................###########
#..................###########.....#........#.....#########..................###########
#..................###########.....#........#.....#########..................###########
#..................###########.....#........#.....#########..................###########
#..................###########.....##########.....#########..................###########
#..................###########....................#########..................###########
#..................###########....................#########..................###########
#..................###########....................#########..................###########
#..................###########....................#########..................###########
#..................###########....................#########..................###########
#..................###########....................#########..................###########
########################################################################################
########################################################################################
########################################################################################
########################################################################################
########################################################################################
########################################################################################
########################################################################################
########################################################################################
########################################################################################
########################################################################################
########################################################################################
#..................###########..................###########..................###########
#..................###########.####.............###########..................###########
#..................###########.#..#.............###########..................###########
#..................#######Town spawn points test completed successfully!
####.#..#.............###########..................###########
#..................###########.####.............###########..................###########
#..................###########..................###########..................###########
#..................###########..................###########..................###########
D..................D##########..................##########D..................D##########
D..................D##########..................##########D..................D##########
#..................###########..................###########..................###########
#..................###########..................###########..................###########
#..................###########..................###########..................###########
#..................###########..................###########..................###########
#..................###########..................###########..................###########
#..................###########..................###########..................###########
#..................###########..................###########..................###########
#..................###########..................###########..................###########
#..................###########..................###########..................###########
########################################################################################
############test map_generator::tests::test_town_spawn_points ... ok
############################################################################
########################################################################################
########################################################################################
########################################################################################
########################################################################################
########################################################################################
########################################################################################
########################################################################################
########################################################################################
########################################################################################
Town generation test completed successfully!
Generated 9 rooms/areas
Map size: 88x88
Spawn points: 8
test map_generator::tests::test_town_generation ... ok
test map_generator::tests::test_map_generation ... ok

test result: ok. 6 passed; 0 failed; 0 ignored; 0 measured; 0 filtered out; finished in 0.00s

