
running 10 tests
test entity::tests::test_entity_creation ... ok
test entity::tests::test_entity_damage ... ok
test entity::tests::test_entity_manager ... ok
test map_generator::tests::test_template_room_creation ... ok
test map_generator::tests::test_town_generation ... ok
test map_generator::tests::test_town_spawn_points ... ok
test map_generator::tests::test_town_structure ... ok
test map_generator::tests::test_town_templates ... ok
test map_generator::dungeon_generator::tests::test_edge_rooms_are_spawn_rooms ... ok
###################################################################################################################
#..................#..................#..................#..................#..................#..................#
#..................#..................#..................#..................#..................#..................#
#..................#..................#..................#....##########....#..................#..................#
#..................#......######......#......######......#....#........#....#......######......#..................#
#..................#......#....#......#......#....#......#....#........#....#......#....#......#..................#
#..................#......#....#......#......#....#......#....#........#....#......#....#......#..................#
#..................#......#....#......#......#....#......#....#........#....#......#....#......#..................#
#..................D......D....D......D......D....D......D....#........#....D......D....D......D..................#
#..................D......D....D......D......D....D......D....#........#....D......D....D......D..................#
#..................#......#....#......#......#....#......#....#........#....#......#....#......#..................#
#..................#......#....#......#......#....#......#....#........#....#......#....#......#..................#
#..................#......#....#......#......#....#......#....#........#....#......#....#......#..................#
#..................#......######......#......######......#....#........#....#......######......#..................#
#..................#..................#..................#....##########....#..................#..................#
#..................#..................#..................#..................#..................#..................#
#..................#..................#..................#..................#..................#..................#
#..................#..................#..................#..................#..................#..................#
#..................#..................#..................#..................#..................#..................#
#########DD#################DD#################DD#################DD#################DD#################DD#########
#..................#..................#..................#..................#..................#..................#
#..................#..................#..................#..................#..................#..................#
#..................#.....######.......#..................#.....########.....#.....######.......#..................#
#..................#.....#....#.......#########DD#########.....#......#.....#.....#....#.......#......######......#
#..................#.....#....#.......#......#...........#.....#......#.....#.....#....#.......#......#....#......#
#..................#.....#....#.......#......#...........#.....#......#.....#.....#....#.......#......#....#......#
#..................#.....######.......#......#...........#.....#......#.....#.....######.......#......#....#......#
#..................D..................D......#...........D.....D......D.....D..................D......D....D......#
#..................D..................D......#...........D.....D......D.....D..................D......D....D......#
#..................#..................###D##########D#####.....#......#.....#..................#......#....#......#
#..................#.....######.......#..................#.....#......#.....#.....######.......#......#....#......#
#..................#.....#....#.......#..................#.....#......#.....#.....#....#.......#......#....#......#
#..................#.....#....#.......#..................#.....#......#.....#.....#....#.......#......######......#
#..................#.....#....#.......#..................#.....########.....#.....#....#.......#..................#
#..................#.....######.......#..................#..................#.....######.......#..................#
#..................#..................#..................#..................#..................#..................#
#..................#..................#..................#..................#..................#..................#
#..................#..................#..................#..................#..................#..................#
#########DD#################DD#################DD#################DD#################DD#################DD#########
#..................#..................#.....................................#..................#..................#
#..................#..................#.....................................#..................#..................#
#..................#.....######.......#.....................................#.....######.......#..................#
#..................#.....#....#.......#.....................................#.....#....#.......#......######......#
#..................#.....#....#.......#.....................................#.....#....#.......#......#....#......#
#..................#.....#....#.......#.....................................#.....#....#.......#......#....#......#
#..................#.....######.......#.....................................#.....######.......#......#....#......#
#..................D..................D.....................................D..................D......D....D......#
#..................D..................D.....................................D..................D......D....D......#
#..................#..................#.....................................#..................#......#....#......#
#..................#.....######.......#.....................................#.....######.......#......#....#......#
#..................#.....#....#.......#.....................................#.....#....#.......#......#....#......#
#..................#.....#....#.......#.....................................#.....#....#.......#......######......#
#..................#.....#....#.......#.....................................#.....#....#.......#..................#
#..................#.....######.......#.....................................#.....######.......#..................#
#..................#..................#.....................................#..................#..................#
#..................#..................#.....................................#..................#..................#
#..................#..................#.....................................#..................#..................#
#########DD#################DD#########.....................................#########DD#################DD#########
#..................#..................#.....................................#..................#..................#
#..................#..................#.....................................#..................#..................#
#..................#.....######.......#.....................................#.....########.....#..................#
#......######......#.....#....#.......#.....................................#.....#......#.....#..................#
#......#....#......#.....#....#.......#.....................................#.....#......#.....#..................#
#......#....#......#.....#....#.......#.....................................#.....#......#.....#..................#
#......#....#......#.....######.......#.....................................#.....#......#.....#..................#
#......D....D......D..................#.....................................#.....D......D.....D..................#
#......D....D......D..................D.....................................D.....D......D.....D..................#
#......#....#......#..................D.....................................D.....#......#.....#..................#
#......#....#......#.....######.......#.....................................#.....#......#.....#..................#
#......#....#......#.....#....#.......#.....................................#.....#......#.....#..................#
#......######......#.....#....#.......#.....................................#.....#......#.....#..................#
#..................#.....#....#.......#.....................................#.....########.....#..................#
#..................#.....######.......#.....................................#..................#..................#
#..................#..................#.....................................#..................#..................#
#..................#..................#.....................................#..................#..................#
#..................#..................#.....................................#..................#..................#
#########DD#################DD#################DD#################DD#################DD#################DD#########
#..................#..................#..................#..................#..................#..................#
#..................#..................#..................#..................#..................#..................#
#..................#.....########.....#.....######.......#.....######.......#.....######.......#..................#
#..................#.....#......#.....#.....#....#.......#.....#....#.......#.....#....#.......#..................#
#..................#.....#......#.....#.....#....#.......#.....#....#.......#.....#....#.......#..................#
#..................#.....#......#.....#.....#....#.......#.....#....#.......#.....#....#.......#..................#
#..................#.....#......#.....#.....######.......#.....######.......#.....######.......#..................#
#..................D.....D......D.....D..................D..................D..................D..................#
#..................D.....D......D.....D..................D..................D..................D..................#
#..................#.....#......#.....#..................#..................#..................#..................#
#..................#.....#......#.....#.....######.......#.....######.......#.....######.......#..................#
#..................#.....#......#.....#.....#....#.......#.....#....#.......#.....#....#.......#..................#
#..................#.....#......#.....#.....#....#.......#.....#....#.......#.....#....#.......#..................#
#..................#.....########.....#.....#....#.......#.....#....#.......#.....#....#.......#..................#
#..................#..................#.....######.......#.....######.......#.....######.......#..................#
#..................#..................#..................#..................#..................#..................#
#..................#..................#..................#..................#..................#..................#
#..................#..................#..................#..................#..................#..................#
#########DD#################DD#################DD#################DD#################DD#################DD#########
#..................#..................#..................#..................#..................#..................#
#..................#..................#..................#..................#..................#..................#
#..................#..................#..................#....##########....#..................#..................#
#......######......#..................#..................#....#........#....#..................#..................#
#......#....#......#..................#..................#....#........#....#..................#..................#
#......#....#......#..................#..................#....#........#....#..................#..................#
#......#....#......#..................#..................#....#........#....#..................#..................#
#......D....D......#..................#..................#....#........#....D..................#..................#
#......D....D......D..................#..................D....#........#....D..................D..................#
#......#....#......D..................#..................D....#........#....#..................D..................#
#......#....#......#..................#..................#....#........#....#..................#..................#
#......#....#......#..................#..................#....#........#....#..................#..................#
#......######......#..................#..................#....#........#....#..................#..................#
#..................#..................#..................#....##########....#..................#..................#
#..................#..................#..................#..................#..................#..................#
#..................#..................#..................#..................#..................#..................#
#..................#..................#..................#..................#..................#..................#
#..................#..................#..................#..................#..................#..................#
###################################################################################################################
test map_generator::tests::test_map_generation ... ok

test result: ok. 10 passed; 0 failed; 0 ignored; 0 measured; 0 filtered out; finished in 0.01s

