
running 7 tests
test map_generator::tests::test_minimum_room_size_enforcement ... ok
test map_generator::tests::test_room_connections ... ok
test map_generator::tests::test_town_has_streets ... ok
test map_generator::tests::test_town_generation ... ok
test map_generator::tests::test_town_templates ... ok
test map_generator::tests::test_town_spawn_points ... ok
###################################################################################################################
#..................#..................#..................#..................#..................#..................#
#..................#..................#..................#..................#..................#..................#
#..................#..................#..................#..................#..................#..................#
#########DD#################DD#################DD#########..................#..................#..................#
#......#...........#......#...........#......#...........#..................#..................#..................#
#......#...........#......#...........#......#...........#..................#..................#..................#
#......#...........#......#...........#......#...........#..................#..................#..................#
#......#...........D......#...........D......#...........D..................D..................D..................#
#......#...........D......#...........D......#...........D..................D..................D..................#
###D##########D#######D##########D#######D##########D#####..................#..................#..................#
#..................#..................#..................#..................#..................#..................#
#..................#..................#..................#..................#..................#..................#
#..................#..................#..................#..................#..................#..................#
#..................#..................#..................#..................#..................#..................#
#..................#..................#..................#..................#..................#..................#
#..................#..................#..................#..................#..................#..................#
#..................#..................#..................#..................#..................#..................#
#..................#..................#..................#..................#..................#..................#
#########DD#################DD#################DD#################DD#################DD#################DD#########
#..................#..................#..................#..................#..................#..................#
#..................#..................#..................#..................#..................#..................#
#..................#..................#..................#..................#..................#..................#
#..................#..................#..................#########DD#########..................#########DD#########
#..................#..................#..................#......#...........#..................#......#...........#
#..................#..................#..................#......#...........#..................#......#...........#
#..................#..................#..................#......#...........#..................#......#...........#
#..................D..................D..................D......#...........D..................D......#...........#
#..................D..................D..................D......#...........D..................D......#...........#
#..................#..................#..................###D##########D#####..................###D##########D#####
#..................#..................#..................#..................#..................#..................#
#..................#..................#..................#..................#..................#..................#
#..................#..................#..................#..................#..................#..................#
#..................#..................#..................#..................#..................#..................#
#..................#..................#..................#..................#..................#..................#
#..................#..................#..................#..................#..................#..................#
#..................#..................#..................#..................#..................#..................#
#..................#..................#..................#..................#..................#..................#
#########DD#################DD################DDD#################DDD################DD#################DD#########
#..................#..................#.....................................#..................#..................#
#..................#..................#.....................................#..................#..................#
#..................#..................#.....................................#..................#..................#
#########DD#################DD#########.....................................#..................#########DD#########
#......#...........#......#...........#.....................................#..................#......#...........#
#......#...........#......#...........#.....................................#..................#......#...........#
#......#...........#......#...........#.....................................#..................#......#...........#
#......#...........D......#...........D.....................................D..................D......#...........#
#......#...........D......#...........D.....................................D..................D......#...........#
###D##########D#######D##########D####D.....................................D..................###D##########D#####
#..................#..................#.....................................#..................#..................#
#..................#..................#.....................................#..................#..................#
#..................#..................#.....................................#..................#..................#
#..................#..................#.....................................#..................#..................#
#..................#..................#.....................................#..................#..................#
#..................#..................#.....................................#..................#..................#
#..................#..................#.....................................#..................#..................#
#..................#..................#.....................................#..................#..................#
#########DD#################DD#########.....................................#########DD#################DD#########
#..................#..................#.....................................#..................#..................#
#..................#..................#.....................................#..................#..................#
#..................#..................#.....................................#..................#..................#
#########DD#################DD#########.....................................#########DD#################DD#########
#......#...........#......#...........#.....................................#......#...........#......#...........#
#......#...........#......#...........#.....................................#......#...........#......#...........#
#......#...........#......#...........D.....................................D......#...........#......#...........#
#......#...........D......#...........D.....................................D......#...........D......#...........#
#......#...........D......#...........D.....................................D......#...........D......#...........#
###D##########D#######D##########D#####.....................................###D##########D#######D##########D#####
#..................#..................#.....................................#..................#..................#
#..................#..................#.....................................#..................#..................#
#..................#..................#.....................................#..................#..................#
#..................#..................#.....................................#..................#..................#
#..................#..................#.....................................#..................#..................#
#..................#..................#.....................................#..................#..................#
#..................#..................#.....................................#..................#..................#
#..................#..................#.....................................#..................#..................#
#########DD#################DD################DDD#################DDD################DD#################DD#########
#..................#..................#..................#..................#..................#..................#
#..................#..................#..................#..................#..................#..................#
#..................#..................#..................#..................#..................#..................#
#########DD#########..................#########DD#################DD#########..................#########DD#########
#......#...........#..................#......#...........#......#...........#..................#......#...........#
#......#...........#..................#......#...........#......#...........#..................#......#...........#
#......#...........#..................#......#...........#......#...........#..................#......#...........#
#......#...........D..................D......#...........D......#...........D..................D......#...........#
#......#...........D..................D......#...........D......#...........D..................D......#...........#
###D##########D#####..................###D##########D#######D##########D#####..................###D##########D#####
#..................#..................#..................#..................#..................#..................#
#..................#..................#..................#..................#..................#..................#
#..................#..................#..................#..................#..................#..................#
#..................#..................#..................#..................#..................#..................#
#..................#..................#..................#..................#..................#..................#
#..................#..................#..................#..................#..................#..................#
#..................#..................#..................#..................#..................#..................#
#..................#..................#..................#..................#..................#..................#
#########DD#################DD#################DD#################DD#################DD#################DD#########
#..................#..................#..................#..................#..................#..................#
#..................#..................#..................#..................#..................#..................#
#..................#..................#..................#..................#..................#..................#
#########DD#########..................#..................#########DD#########..................#########DD#########
#......#...........#..................#..................#......#...........#..................#......#...........#
#......#...........#..................#..................#......#...........#..................#......#...........#
#......#...........#..................#..................#......#...........#..................#......#...........#
#......#...........D..................D..................D......#...........D..................D......#...........#
#......#...........D..................D..................D......#...........D..................D......#...........#
###D##########D#####..................#..................###D##########D#####..................###D##########D#####
#..................#..................#..................#..................#..................#..................#
#..................#..................#..................#..................#..................#..................#
#..................#..................#..................#..................#..................#..................#
#..................#..................#..................#..................#..................#..................#
#..................#..................#..................#..................#..................#..................#
#..................#..................#..................#..................#..................#..................#
#..................#..................#..................#..................#..................#..................#
#..................#..................#..................#..................#..................#..................#
###################################################################################################################
test map_generator::tests::test_map_generation ... ok

test result: ok. 7 passed; 0 failed; 0 ignored; 0 measured; 0 filtered out; finished in 0.01s

