
running 10 tests
test entity::tests::test_entity_creation ... ok
Central room width: 39
Central room height: 39
Central room width: 39
Central room height: 39
test entity::tests::test_entity_damage ... ok
test entity::tests::test_entity_manager ... ok
test map_generator::tests::test_town_generation ... ok
test map_generator::tests::test_town_spawn_points ... ok
test map_generator::tests::test_template_room_creation ... ok
test map_generator::tests::test_town_templates ... ok
test map_generator::tests::test_town_structure ... ok
Edge room at (0, 0) has type: Spawn with 0 spawn points
Edge room at (1, 0) has type: Spawn with 2 spawn points
Edge room at (2, 0) has type: Spawn with 2 spawn points
Edge room at (3, 0) has type: Spawn with 4 spawn points
Edge room at (4, 0) has type: Spawn with 2 spawn points
Edge room at (0, 1) has type: Spawn with 2 spawn points
Edge room at (4, 1) has type: Spawn with 0 spawn points
Edge room at (0, 2) has type: Spawn with 2 spawn points
Edge room at (4, 2) has type: Spawn with 2 spawn points
Edge room at (0, 3) has type: Spawn with 2 spawn points
Edge room at (4, 3) has type: Spawn with 4 spawn points
Edge room at (0, 4) has type: Spawn with 4 spawn points
Edge room at (1, 4) has type: Spawn with 4 spawn points
Edge room at (2, 4) has type: Spawn with 2 spawn points
Edge room at (3, 4) has type: Spawn with 2 spawn points
Edge room at (4, 4) has type: Spawn with 0 spawn points
Found 16 spawn rooms out of 16 total edge rooms
Total spawn points from ALL spawn rooms: 34
Total spawn points in generator: 34
test map_generator::dungeon_generator::tests::test_edge_rooms_are_spawn_rooms ... ok
###################################################################################################################
#..................#..................#..................#..................#..................#..................#
#..................#..................#..................#..................#..................#..................#
#..................#..................#..................#....##########....#..................#..................#
#..................#......######......#......######......#....#........#....#......######......#..................#
#..................#......#....#......#......#....#......#....#........#....#......#....#......#..................#
#..................#......#....#......#......#....#......#....#........#....#......#....#......#..................#
#..................#......#....#......#......#....#......#....#........#....#......#....#......#..................#
#..................D......D....D......D......D....D......D....#........#....D......D....D......D..................#
#..................D......D....D......D......D....D......D....#........#....D......D....D......D..................#
#..................#......#....#......#......#....#......#....#........#....#......#....#......#..................#
#..................#......#....#......#......#....#......#....#........#....#......#....#......#..................#
#..................#......#....#......#......#....#......#....#........#....#......#....#......#..................#
#..................#......######......#......######......#....#........#....#......######......#..................#
#..................#..................#..................#....##########....#..................#..................#
#..................#..................#..................#..................#..................#..................#
#..................#..................#..................#..................#..................#..................#
#..................#..................#..................#..................#..................#..................#
#..................#..................#..................#..................#..................#..................#
#########DD#################DD#################DD#################DD#################DD#################DD#########
#..................#..................#..................#..................#..................#..................#
#..................#..................#..................#..................#..................#..................#
#..................#..................#.....######.......#..................#.....########.....#..................#
#..................#########DD#########.....#....#.......#########DD#########.....#......#.....#......######......#
#..................#......#...........#.....#....#.......#......#...........#.....#......#.....#......#....#......#
#..................#......#...........#.....#....#.......#......#...........#.....#......#.....#......#....#......#
#..................#......#...........#.....######.......#......#...........#.....#......#.....#......#....#......#
#..................D......#...........D..................D......#...........D.....D......D.....D......D....D......#
#..................D......#...........D..................D......#...........D.....D......D.....D......D....D......#
#..................###D##########D#####..................###D##########D#####.....#......#.....#......#....#......#
#..................#..................#.....######.......#..................#.....#......#.....#......#....#......#
#..................#..................#.....#....#.......#..................#.....#......#.....#......#....#......#
#..................#..................#.....#....#.......#..................#.....#......#.....#......######......#
#..................#..................#.....#....#.......#..................#.....########.....#..................#
#..................#..................#.....######.......#..................#..................#..................#
#..................#..................#..................#..................#..................#..................#
#..................#..................#..................#..................#..................#..................#
#..................#..................#..................#..................#..................#..................#
#########DD#################DD#################DD#################DD#################DD#################DD#########
#..................#..................#.....................................#..................#..................#
#..................#..................#.....................................#..................#..................#
#..................#.....######.......#.....................................#.....######.......#..................#
#..................#.....#....#.......#.....................................#.....#....#.......#......######......#
#..................#.....#....#.......#.....................................#.....#....#.......#......#....#......#
#..................#.....#....#.......#.....................................#.....#....#.......#......#....#......#
#..................#.....######.......#.....................................#.....######.......#......#....#......#
#..................D..................D.....................................D..................D......D....D......#
#..................D..................D.....................................D..................D......D....D......#
#..................#..................#.....................................#..................#......#....#......#
#..................#.....######.......#.....................................#.....######.......#......#....#......#
#..................#.....#....#.......#.....................................#.....#....#.......#......#....#......#
#..................#.....#....#.......#.....................................#.....#....#.......#......######......#
#..................#.....#....#.......#.....................................#.....#....#.......#..................#
#..................#.....######.......#.....................................#.....######.......#..................#
#..................#..................#.....................................#..................#..................#
#..................#..................#.....................................#..................#..................#
#..................#..................#.....................................#..................#..................#
#########DD#################DD#########.....................................#########DD#################DD#########
#..................#..................#.....................................#..................#..................#
#..................#..................#.....................................#..................#..................#
#..................#.....########.....#.....................................#.....######.......#..................#
#......######......#.....#......#.....#.....................................#.....#....#.......#..................#
#......#....#......#.....#......#.....#.....................................#.....#....#.......#..................#
#......#....#......#.....#......#.....#.....................................#.....#....#.......#..................#
#......#....#......#.....#......#.....#.....................................#.....######.......#..................#
#......D....D......D.....D......D.....#.....................................#..................D..................#
#......D....D......D.....D......D.....D.....................................D..................D..................#
#......#....#......#.....#......#.....D.....................................D..................#..................#
#......#....#......#.....#......#.....#.....................................#.....######.......#..................#
#......#....#......#.....#......#.....#.....................................#.....#....#.......#..................#
#......######......#.....#......#.....#.....................................#.....#....#.......#..................#
#..................#.....########.....#.....................................#.....#....#.......#..................#
#..................#..................#.....................................#.....######.......#..................#
#..................#..................#.....................................#..................#..................#
#..................#..................#.....................................#..................#..................#
#..................#..................#.....................................#..................#..................#
#########DD#################DD#################DD#################DD#################DD#################DD#########
#..................#..................#..................#..................#..................#..................#
#..................#..................#..................#..................#..................#..................#
#..................#.....######.......#..................#.....######.......#..................#..................#
#..................#.....#....#.......#########DD#########.....#....#.......#########DD#########..................#
#..................#.....#....#.......#......#...........#.....#....#.......#......#...........#..................#
#..................#.....#....#.......#......#...........#.....#....#.......#......#...........#..................#
#..................#.....######.......#......#...........#.....######.......#......#...........#..................#
#..................D..................D......#...........D..................D......#...........D..................#
#..................D..................D......#...........D..................D......#...........D..................#
#..................#..................###D##########D#####..................###D##########D#####..................#
#..................#.....######.......#..................#.....######.......#..................#..................#
#..................#.....#....#.......#..................#.....#....#.......#..................#..................#
#..................#.....#....#.......#..................#.....#....#.......#..................#..................#
#..................#.....#....#.......#..................#.....#....#.......#..................#..................#
#..................#.....######.......#..................#.....######.......#..................#..................#
#..................#..................#..................#..................#..................#..................#
#..................#..................#..................#..................#..................#..................#
#..................#..................#..................#..................#..................#..................#
#########DD#################DD#################DD#################DD#################DD#################DD#########
#..................#..................#..................#..................#..................#..................#
#..................#..................#..................#..................#..................#..................#
#..................#..................#..................#....##########....#..................#..................#
#......######......#..................#..................#....#........#....#..................#..................#
#......#....#......#..................#..................#....#........#....#..................#..................#
#......#....#......#..................#..................#....#........#....#..................#..................#
#......#....#......#..................#..................#....#........#....#..................#..................#
#......D....D......#..................#..................#....#........#....D..................#..................#
#......D....D......D..................#..................D....#........#....D..................D..................#
#......#....#......D..................#..................D....#........#....#..................D..................#
#......#....#......#..................#..................#....#........#....#..................#..................#
#......#....#......#..................#..................#....#........#....#..................#..................#
#......######......#..................#..................#....#........#....#..................#..................#
#..................#..................#..................#....##########....#..................#..................#
#..................#..................#..................#..................#..................#..................#
#..................#..................#..................#..................#..................#..................#
#..................#..................#..................#..................#..................#..................#
#..................#..................#..................#..................#..................#..................#
###################################################################################################################
test map_generator::tests::test_map_generation ... ok

test result: ok. 10 passed; 0 failed; 0 ignored; 0 measured; 0 filtered out; finished in 0.01s

